5 11
|--------|
|.F.|..-.|
|..-|.@..|
|.F....-.|
|--------|
